
N N N N N N N N N N N N N
N - - - - - - - - - - - N
N - - - - - - - - - - - N
N N N N N N N N N N N N N
N - - - - - - - - - - - N
N - - - - - - - - - - - N
N - N N - - - - - N N - N
N - - - - - - - - - - - N
N - P - - N N N - - K - N
N - - - - - - - - - - - N
N N N N N N N N N N N N N