
N N N N N N N N N N N N N
N - - - - - - - - - - - N
N - - - - - - - - - - - N
N N N N N N N N N N N N N
N - - - - - - - - - - - N
N - - - - - - - - - - - N
N - N N - - - - - N N - N
N - - - - - - - - - - - N
N - - - - N N N - - - - N
N - P - - - - - - - K - N
N N N N N N N N N N N N N